text	reference
yma gyfleusderau da i brynu tir i 'w adael i godipris, neu i fyned i fyw arno. Nid oes treth ardir y llywodraeth am bum mlynedd, felly, nidoes traul wrth adael y tir i sefyll; ac fe fydd yn	Amer 28.  4
Y peth mwyaf annghysurus yn y gymydogaethhon yw y tywydd oer a 'r eira mawr yn y Gauaf,yr hwn sydd yn parhau o bedwar i bum mis. Ymae y wlad hon yn iachach na 'r sefydliadau	Amer 31.  14
J. Richards. Methais gael gwybod rhifedi aelodaua phregethwyr y Trefnyddion Calfinaidd; y maeganddynt bump o addoldai yn y gwahanolgymydogaethau	Amer 32.  19
Hefyd am ddyblu y breuddwyd i Pharao//      ddwywaith,  o blegit siccrhau y//      peth gan Dduw, a bod Duw yn bryssio i 'w//      wneuthur.Weithian gan hynny edryched Pharao//       wr deallgar a doeth, a gosoded ef yn swyddog ar wlad yr Aipht.Gwnaed Pharao hyn, sef gosoded olygwyr ar y wlad a chymmered bummed ran//       gwlad yr Aipht tros saith mlynedd yr//      amldra.Yna casglant holl ymborth y blynyddoedd daionus hynny y rhai ydynt ar ddyfod://      sef casclant yd dan law Pharao, a chadwant//       mewn dinasoedd.	b1588 b1588gen 41  34
A 'r Philistiaid oeddynt yn sefyll ar fynydd//      //      o 'r naill du, ac Israel oeddynt yn sefyll ar fynydd o 'r tu arall, a 'r dyffryn  rhyngddynt.Yna y daeth gwr rhyngddynt hwy o werssylloedd y Philistiaid a 'i enw Goliath o Gath: ei//      vchter  chwe chufydd a rhychwant.A helm o bres ar ei ben, a lluric emmoc a//      wiscodd efe, a phwys y lluric  bum mil o//      siclau pres.A bottyssau pres  am ei draed ef,//      a tharian pres rhwng ei yscwyddau.	b1588 b1588sam 17  5
A Saul a wiscodd Ddafydd a 'i wiscoedd//      ei hun, ac a roddodd helm o bres ar ei benn ef://      ac a 'i gwiscodd ef  lluric.Yna y gwregysodd Dafydd ei gleddyf//      ar vchaf ei wiscoedd, ac a geisiodd gerdded am//      na phrofase efe, yna y dywedodd Dafydd wrth//      Saul, ni allafi fyned yn y rhai hyn, canys ni//      phrofais i: am hynny y dioscodd Dafydd hwynt oddi am dano.Yna y cymmerth efe ei ffon yn ei law,//      ac a ddewisodd iddo bump o gerric llyfnion o 'r//      afon, ac a 'i gosododd hwynt yng-hod  y bugeiliaid yr hon  ganddo, sef yn yr screpan: a 'i ffon//      dafl  yn ei law ef: ac efe a nessaodd at//      y Philistiad.A 'r Philistiad a gerddodd, gan fyned, a//      nessau at Ddafydd: a 'r gwr oedd yn cludo y tarian o 'i flaen ef.	b1588 b1588sam 17  40
Fab y weddw, o feirw i fowredd, \Rhoi'r dall: i weled pob rhyw wall, \Fe borthe gwaelion bum mil dynion, \Fe ddysge'r gwirion ffordd gyfion i syw'n gall, \	BER BWB_334-2 ^  86
Roedd iddi 'n rhanne o honno, \Mae 'n debyg inni i 'w dybio, \Bum waith i 'w dystio mwy na 'i Dad, \Ffei o Wraig mae 'n ffiedd rwygiad, \	BER BWB_371-2 6  60
Wrth reol yr wybur ni all llwubur yn llawn,Yn dalld mae drudanieth yn ddifeth a ddaw,Tros gyflawn bumlynedd yn bruddedd mewn *braw.Credadun.	BHJ BWB_108-1 ^  88
MeddwynWrth wrando ar dy ffalsder yn yfnder  y nosBum ganwaith ar rynu ne fferu yn y ffos,Ar ol gwario'r mawr Arian modd ruan Bob tro	BHJ BWB_112-2 ^  42
Yn d adel di i sefull yn *suful gar *Bron,Na Roe fedi'n foddfa fel Sodama 'n siwr,Lle syrthiodd yn wnias Bum dinas mewn dwr.D.	BHJ BWB_112-2 ^  100
Yr owan *Rhoi ffarwel air Tawel iti,Ir Bud Rydw i'n siampal Rhu feddal wi fi,Lle Bum yn cael gormod dwlamod di les,Yr owan rhu fychan yn gyfan a ges.	BHJ BWB_112-2 ^  123
Maer Arian gwedi darfod,Yn Trafaelio dros dy Sarn,Bum arnat ddarn o ddiwrnod.Os eis di 'n wael dy gwman,	BHJ BWB_171-1 ^  12
Cest amal Beint heb dalu,Ath dendio gyd a hynu,Bum lawer Nos cin tori 'r wawr,Heb fynd i lawr i gysgu	BHJ BWB_171-1 ^  31
nid meddwi 'n ffraeth mewn moddion *ffri neu guro'n llaes am gwrw'n lliOnd gweddeidd-dra fyna fi a hyn rwi yw hoffi o hyd,Os bum im Trin ar lawer tro yn feddwyn llaith un fodd a lloffarwel ir dafarn gadarn go dof eto i mendio y myd,	BHJ BWB_172-2 6  23
Merch a garwn a'i theg eiriePan ddoe, yn ei blode a'i modde ir manMerch o ddifri bum iw hoffiAm Clwyfodd gwedi wisgi waith	BHJ BWB_480-2 ^  29
dda agwedd fwun ddiogel yn rhifo gwur i ryfelam hoedel gafel guryn lle gwr bum i 'n siwr mewn amal daro ar dir a dwryn rhyfela 'n nerth y cledde am fy mowud Efo mwa	BLl   989
enter capten mortimerIechud ichwi lan ferch grynowuch gowreindeb bum i 'ch gwrandoych tryth a 'ch cyffes sudd a 'ch trallod	BLl   1013
er pen ydech imi 'n bartneryn cud gysgu a chud gyfeddacherioed ni wubum mai merch oeddechffabian	BLl   1027
nid ydwi ond drwg wrth swmbwlni roi mo ngalon  dan fy nroed ni bum i erioed ar feddwlmi wisca ddillad gwchion	BLl   1150
cewch barch Twusoges fel 'r heuddechers tair blynedd drwu fawr drafela bum i 'n cynal fflit i ryfelyn colli gwaed ac arfe ag arian	BLl   1253
gael twls  yn lle cledde cri o euddo iti dy hunanllawer gwaith a bum i 'n rhyfeddupa sut a bu hi cud yn cyscu	BLl   1302
ag ar i llyfon wneuthur gwada gyru nhad  o 'i dyrnasTair blynedd bum i 'n cario cleddmi af dair blynedd newudd	BLl   1410
i 'm dwu ferch i dyngu anudondeigien mlynedd mi  fynegaa bum i 'n frenin yn Mrutaniadrwu gario 'n  ddidwn y goron ddedwudd	BLl   1634
enter plwcow llur gru a 'r llaw grafellni wubum rioed dy fod mor musgrella rhoi dy dorth i wr o 'th bro 	BLl   1811
i dyngu llw kowirdeb i vrenhin Sion o Loegr. yCymru ai galwai Ieuan vrenhin.Yn yr ail vlwyddyn i gwelad yn Swydd Iork bumplleuad ar vnwaith ar yr awyr ar  ail gayaf	CHSM 204v.  20
i bu vaes creulon ar Saesson a gafas y gore aca ennillodd y Dref ac yno i lladdwyd or y Scottiedbump mil arhugein ar brenhin a ymroes gwedihynny i Edward./	CHSM 207r.  20
i Harri i vrawd ac ai byriodd allan ac aladdoddbum mil oi wyr ac a gafas Petyr lawer ogestyll a threfydd drychefn yr rhai a ynnillyssai	CHSM 210r.  8
yng Hawnterburi i claddwydHarri y pumedHarri bumed a ddechreuodd yr .21. dydd o Vawrthoed Crist 1412. ac a goronwyd yn Westmustr y	CHSM 212v.  15
Y vlwyddyn honn vis hydref i bu yr maes yn Agincowrttrwy wyrthie Duw ai weithred i hennillodd gwyr Loegrac nid oedd o lu gan vrenhin Harri bumed onddwyfil	CHSM 213r.  22
y Duc o Betphord i vrawd a llu gantho ar y mora gydiodd a llonge brenhin Phraink hyd yn rhif obumkann//       llong ac ai lladdodd ac ai boddodd ac ai daloddi gyd a phann glybu y llu oedd ar dir hynny hwynt	CHSM 213v.  10
yr honn a vu gwedi hynny vrenhines, Ciceli a Chatrin./Edward y pumedEdward bumed a ddechreuodd meddiannu yrYnys honn yr .11. dydd o Ebrill pan oedd oedran	CHSM 7.  1
i vrenhin Phrainc eilwaith. Yr ailvlwyddyny dewisswyd Siarls bumed yn EmperodrRhufain. Ar vlwyddyn honn i danfoned Iarll	CHSM 223v.  18
ddymuniadauam iachawdwriaeth yn fuan ar ol dyfod i 'chty chwi i 'r ysgol: ond ni bum erioed o 'r blaen fel ydiwrnod hwnnw; ac nis anghofiaf hynny byth. Wrth	CMB 14.  25
i minnau, fel y gallwn fyw mewn hyfrydwch, a marwmewn heddwch; ac ymddangosodd yn bur debyg i miy byddai felly. Ni bum erioed o 'r blaen mor gysurusyn achos fy enaid. Mynych, fynych yr oedd y	CMB 7.  12
i Blant. Gofynais iddi,"Beth yr ydych yn ei ddarllen?"Attebodd hithau, "Bum yn darllen ac yn meddwllawer ar y geiriau hyn yn y llyfr bach yma."	CMB 17.  22
anwrthwynebolat bethau ysprydol.Bum am dro yn syllu mewn distawrwydd ar y corphmarw, ac o 'r braidd yr oeddwn yn gallu credu nad	CMB 44.  33
y maent yna. Nid rhyfedd yn wir ebr fi,a hawddgared ydynt, pettwn perchen traeda dwylo fel y bum, minneu awn i garuneu addoli y rhain. Taw, taw, ebr ynte,	GBC 10.  29
a Llys teg iawn, ac arno wedi derchafu 'nuchel hanner lleuad ar Faner aur, wrth hyngwybum mai 'r Twrc oedd yno. Nesa at yPorth ond y rhain, oedd lys Lewis XIV. o	GBC 16.  12
ddwg dy holl stat oddiarnat, a chwil gwydd,heb nac iawn na rhwymedi i gael arno? Apheth yw Pigwr-pocced, a ddygobumpynt,wrth gogiwr dis, a 'th yspeilia o	GBC 21.  27-28
Brydydd ac yn Gyfreithiwr, pwy a wyr p'runai Cig ai Pyscod fyddei: ac yn siccr, osbyddei 'n un o Wyr Llys fel y bum i, acyn gorfod iddo newid ei flas at bob geneu.	GBC 62.  12
gael ei ddanfon gan Dduw; yn drydydd, i ymarferymolchiadau yn fynych, ac ymburo; yn bedwarydd,i weddio ar yr amser gosodedig; yn bummed, i roielusennau; yn chwechfed, i ymprydio yn mis	HHGB 53.  33
bererindod i Mecca; yn wythfed, i ymwrthod aphob chwaryddiaeth a diod gadarn; yn nawfed, ibriodi dan bump ar hugain oed; ond nid i gaelychwaneg	HHGB 53.  38
Ni fu fy meistres fwyn, dirion, fyw ond dwyflynedd ar ol fy meistr. Ei marwolaeth hi fu golledmawr i mi. Hi adawodd ar ei hol bum mab, ollyn wyr ieuaingc grasol, ac yn weinidogion yr	JAUG 24.  8
dalu iddo, i ba beth y cyttunais. Enw ein captenoedd -  -  -   -  -  -  mi aethum dan enw cogydd iddo.Yn agos i St. Dominigo ni a ddaethom i fynu at bumpo longau marsiandwyr Ffraingc. Fe ddarfu in' gael	JAUG 25.  22
ei gynnyg; ond fe wnaeth i mi roddi hannercoron am fyned gyd a mi, ac eilwaith wnaeth i miroddi iddo bum swllt yn rhagor am fy arwain i dycyfarfod Dr. Gifford.	JAUG 30.  28
Gwelwn freuddwyd go ddrych aniali//        'm dychrynnuBum felly dros awrAc yn fy Mreuddwyd mi welwn ryw guttog	LlGM LlGM16   5
Cyngor Hen Wraig i//        'w Mab. Y Mesur//Cwympiad y Dail.Happiodd i mi wrth DrafaelioSyrthio i 'r fann lle bum yn gwrandoAr gyf'rwyddyd Gwraig yn dysgu	LlGM LlGM17   2
Ag y cynhaliwyd Hwnn o hydEr dechreuad hynn o brydNi bum ond ennyd ynddoNid wyf ond gwirion Duw 'n fy rhann	LlGM LlGM19   4
Lhe mae goreu cael fy Ngweled.I b'le gann hynny 'r ei di heno?Lle bum i Neithiwr 'rwy 'n gobeithioOes Cydnabyddiaeth iti 'n agos?	LlGM LlGM35   6
fwyfwy'r Clwt, fwyfwy'r Cadach, ac ymhell ybwyf, (ie pellach o Fon nag ydwyf) os gwn i pa'r fyda'm dwg. Ni's gwybum i mo'm geni, er clywed ganfy Mam ganwaith, nes dyfod i fysg y Saeson drelion	LlGO LlGO_BLAdd15037_10 45r.  13
Clochydd. Ac yn wir y Clochydd a fyddai 'n eichadw o'r blaen ond bod y Curad yn rhoi iddobumpunt o'r tair ar ddeg am ei boen. Ond nidoes erbyn edrych gan y Plwyfolion ddim	LlGO LlGO_NLW17B_20 245.  11
Myfi sydd (megys) Llew rhag (y) llu a ruthrant lychiant ar fy nghaerau;Ie'n siwr. Dyn gwych a Gwalchmai.Bum yn effro trwy'r nos yn cadw (y) terfyn(wrth) Rhydau wedi eu harloesi, Dwr a dynn y Cenn	LlGO LlGO_NLW17B_22 249.  23
anghysurus a glywsoch o Gaer Nerpwl,oblegid ni chlywais i ddim rhyfedd sydd yn nesatti. Gwir yw, ni bum yno erys Ennyd, ond odidi ddim a dalo i son am dano ddigwydd yno	LlGO LlGO_NLW17B_30 273.  10
ddrewedig anaele. Fe debygai Ddyn wrth Dafodac Araith Elisa mai ar laeth Gast y magesid efynghymysg ag Album Graecum, ac mai Swyddei Dafod, cyn dysgu siarad, oedd llyft_n_u, ac	LlGO LlGO_NLW17B_46 314.  2
ga'dd ei ladd gan ei frawd Dafydd. Ond rhyfedd iHowel, ac ynteu'n fab i Wyddeles, fod cystal Bardd?Ni chlybum ermoed son am ddim o waith Dafyddap Owain Gwynedd, er ei fod yn Gymro	LlGO LlGO_NLW17B_50 323.  12
and worn out with Cares and Afflictions can't hold Gwnaed Duw a fynno.  -Ni bum yn glaf Galan ermoed o'r blaen, am hynymi wneuthum ryw fath ar Gywydd i hwn, sef y Calan	LlGO LlGO_NLW17B_52 331.  4
Purdan? Os Penyd a wna'r tro , wele ddigoneisus, fod cyhyd heb glywed oddiwrthych, a thradiddaned i'm gynt eich Epistolau! Tra bumyn Llundain, un Achos arbennig na	LlGO LlGO_NLW17B_62 338.  19
Northolt Iune 25. 1757.Y Cydwladwr mwyn,Doe y bum yn Llundain yn ymweled a'chBrawd ac yn rhywsut fe ffynnodd genym fod yn	LlGO LlGO_NLW17B_73 343.  9
tros dippin o flynyddodd, mi rwufi yn gobeithio y cewchchwi (fy nheulu) fy ngweled i er ich cysur; nid iw  fi ddimyn ame na bum i yn llawer o flinder i bob un ohonoch,Ond nid oedd gennif ddim help os oeddwn ni yn ddi barch	NLW2722E NLW2722E_2 4.  32
ar hon Vair // i vamaethY bumed rinwedd enwoggael o Elen lueddog	Pen218 Pen218_Ateb   85
nas gellir i ti mo 'r ymddiried.y Dyllvan:/O bum mewn tai gweigionheb wybod y 'w perchnogion	Pen218 Pen218_Wtreswr   41
modd i gwelais yn greulongwedi yfed mwy na digonmewn tafarne y bum inevagad o nosweithie	Pen218 Pen218_Wtreswr   183
os gelli aros etto vunudmae rhagor gennyf y 'w ddoedydModd i bum yn llechu weithieyn gwrando ar gadw dadle	Pen218 Pen218_Wtreswr   345
mae llawer maen gwrthfawrAc ynddi y mae hevydlysowod o bum gwrydac o vewn i hamgylchoedd	Pen218 Pen218_Mandefil   276
yr unved flwyddyn ar ddec ar hvgaint gwedidyvod y saesson i 'r tir / a gwedi parhav o 'r frenhiniethhonn 231 o flynyddoedd dann bump nev chwecho frenhinoedd yr aeth hi i frenhin West Sex oed krist	RhY 28.  22
dioddefwch y//       'n eneidieyn dragwyddawl//        fyw yn yr unlleIti Troya bum ynot vyw mewn dolurdithe Priaf a//       'm holl gowir vrodur	TCh   1757
a chalon drom amdanad hawdd y galla hiraethua vu neb o ddydd i nos o nos i ddydd yn wyloy modd y bum if yn aros y decfed//        noswaith henoTyr//         ed _y_e_//         wyt ti/n/ agos	TCh   2206
Arthur hwynt, a rhoi i farchogion o'r naill tu a Morydd,iarll Caerloiw, o'r blaen. A beddino i lu a wnaeth yn wythbyddin, ag ir oedd bum cant a chwe mil o wyr ymladdprofadwy ymhob byddin. Ag yna, wedi i parattoi hwynt	YK Llst 129, 45r.  1
